0000000000000000000000000000000000000000000000000000000000000000000000000000000000000000000000000000000000000000000000000000000000000000
0000000000000000000000000000000000000000000000000000000000000000000000000000000000000000000000000000000000000000000000000000000000000000
0000000000000000000000000000000000000000000000000000000000000000000000000000000000000000000000000000000000000000000000000000000000000000
0000000000000000000000000000000000000000000000000000000000000000000000000000000000000000000000000000000000000000000000000000000000000000
0000000000000000000000000000000000000000000000000000000000000000000000000000000000000000000000000000000000000000000000000000000000000000
0000000000000000000000000000000000000000000000000000000000000000000000000000000000000000000000000000000000000000000000000000000000000000
0000000000000000000000000000000000000000000000000000000000000000000000000000000000000000000000000000000000000000000000000000000000000000
0000000000000000000000000000000000000000000000000000000000000000000000000000000000000000000000000000000000000000000000000000000000000000
0000001111111111111111111111111111111111111111111111111111000000000000000000000000000000000000000000000000000111000000000000000000000000
0000001111111111111111111110000111000000110000000000000011000000000000000000000000000000000110000000000001111111100000000000000000000000
0000000000011111111100000000000000000000110000000000000011000000000000000000000000000000000110000000000001111111100000000000000000000000
0000000000000000000000000000000000000000110000000000000011000000000000000000000000000000000110000000000001111111100000000040001111000000
0000000000000000000000000001100000001111111111111111110011000000000000000000000000000000000110000000000001111111111111111111111111000000
0000000000000000000000000001100000000000000000000000010011000000000000000000000000000000000110000000000000000011100000000111000000000000
0000000000000000000000000001100000000000000000000000010011000000000000000000000000000000000111111111111111111111111111111111111110000000
0000000000000000000000000001100000000000000000000000010000000000000000000000000000000000000111111111111110000000001111111111111110000000
0000000000000000000000000001100000000000000000000000010000000000000000000000000000000000000111000011110000000000001111111100001110000000
0000000000000000000000000001000000000000000000000040010000000000000000000000000000000000000111000000000000000000000000000000001110000000
0000001111100000000011111111111111111111111111111111111111111111111111113222222220000000000111000000000000000000001001000000001110000000
0000001111100000000011111111111111111111111111111111111111111111111111113222222220000000000111000000000000000000000000000000001110000000
0000001111100000000001111111111111111111111111111111111111111111111111113222222220000000000111000000000000000000000040000000001110000000
0000001111111111111111111111111111111111111111111111110000000000001111113222222110000000000111111111111100000000000111111111101110000000
0000001111111111111111111100000011101111111111111111110000000000001111113222222110111111110111111111111100000000000111111111111110000000
0000001111111111111111110000000000000000000110000000000000000000001111113111100000000000000111111111111100000000000111111111111110000000
0000001111111100011111110000000000000000000111000000000000000000003311330111100000000111001111100000000000000000000000000000111110000000
0000001111111100011111111011111100000000000111000000000000000000001111111111100000000111111111100000000000000000000000000000111110000000
0000001111111100011111111011111100000000040111000000000011000000001111111111100000000111111111100000000000000000000000000000111110000000
0000001111111100011111111000000000004000010111000000000011000000001100001111100111100111111111100000000000000000000000000000111110000000
0000001111111111111111111000000001111111111111111111111111000000003300001133333300000000000111100000000000000000000000000000111110000000
0000001111111111111111110088888800000000000111000000000011000000001000001111111110000000000111000000000000000400000000000000111110000000
0000001111111111111111111111111111111111111111111111110011000000000000101111111110000000000111100000000000111111110000000000111110000000
0000000000111111110000111111111111000000000000000000000011000000001111111111110110000000000111111111111111111111111111111111111110000000
0000000000000000000000000011111111000000000000000000000011000000001111111111111100000000000111111111111111111111111111111111111110000000
0000000000000000000000000011111111000000000000000000000011000000000000000000000000000000000111000000000111100000000110000000001110000000
0000000000000000000000000011111111000000000000000000000011000000000000000000000000000000000111000010001000000000000110000000001110000000
0000000000000000000000000011111111000000000000000000000011000000000000000000000000000000000111000001010000000000000000000000001110000000
0000001111000400001111000011111111111111111111111111111111000000000000000000000000000000000111000000000000000000000100000000001110000000
0000001111111111110111000011111111111111111111111111111111000000000000000000000000000000000111000000400000000000000100000000001110000000
0000001111111111111111000011111111111111111111111111111111000000000000000000000000000000000111111111111111111111111111111111111110000000
0000003333331133333333000000000000000000001000000000011111000000000000000000000000000000000111111111111111111111111111111111111110000000
0000001111111111111111000000000000000000001000000000011111000000000000000000000000000000000111100000000000011111111000000000000110000000
0000001111111111111111111100000000000000001000000000011100000000000000000000000000000000000111100000000000011111111000000000000110000000
0000001111111111111111111111111111111111111111111111111100000000000000000000000000000000000000000000000000011111111000000000000000000000
0000000000000000000000000000000000000000000000000000000000000000000000000000000000000000000000000000000000001111110000000000000000000000
0000000000000000000000000000000000000000000000000000000000000000000000000000000000000000000000000000000000000111100000000000000000000000
0000000000000000000000000000000000000000000000000000000000000000000000000000000000000000000000000000000000000000000000000000000000000000
0000000000000000000000000000000000000000000000000000000000000000000000000000000000000000000000000000000000000000000000000000000000000000
0000000000000000000000000000000000000000000000000000000000000000000000000000000000000000000000000000000000000000000000000000000000000000
0000000000000000000000000000000000000000000000000000000000000000000000000000000000000000000000000000000000000000000000000000000000000000
0000000000000000000000000000000000000000000000000000000000000000000000000000000000000000000000000000000000000000000000000000000000000000
